Тело
arm -- рука
back -- спина
beard -- борода
bone -- кость
buttocks -- ягодицы
cheek -- щека
chest -- грудь
chin -- подбородок
ear -- ухо
elbow -- локоть
eye -- глаз
eyebrow -- бровь
face -- лицо
finger -- палец на руке
foot (pl. feet) -- ступня
forehead -- лоб
hair -- волосы
hand -- кисть руки
head -- голова
heart -- сердце
heel -- пятка
knee -- колено
leg -- нога
lips -- губы
mouth -- рот
mustache -- усы
nail -- ноготь
neck -- шея
nose -- нос
organ -- орган
shoulder -- плечо
skin -- кожа
spine -- позвоночник
stomach -- живот, желудок
throat -- горло
toe -- палец на ноге
tongue -- язык
tooth -- зуб
