Одежда
belt -- пояс, ремень
blouse -- блузка
boot -- сапог, ботинок
cap -- кепка
cardigan -- кардиган, кофта
coat -- пальто
to dress -- платье
glove -- перчатка
hat -- шляпа
hood -- капюшон
jacket -- жакет, пиджак, куртка
jeans -- джинсы
pyjamas (AmE: pajamas) -- пижама
scarf -- шарф
shirt -- рубашка
shoes -- обувь
shorts -- шорты
skirt -- юбка
sock -- носок
to suit -- костюм
 -- идти к лицу
sweater -- свитер
tie -- галстук
tights -- колготы
trainers (AmE: sneakers) -- кроссовки
trousers (AmE: pants) -- штаны
T-shirt -- футболка
underwear -- нижнее белье
bracelet -- браслет
earring -- сережка
glasses -- очки
necklace -- ожерелье
purse -- дамская сумка, кошелек
wallet -- бумажник
